
0000000000000000000
0000000000000000000
0000000000000111000
0000000000111000000
0000000000000000000
0000000000000000000
0000000000000000000
0000000000000000000
0000000000000000000
0000011111111000000
0000000000000000000
0000000000000000000
0000000000000000000
0000000000000000000
0000000000000000000
0000000000000000000
0011111110011100000
0000000000000000000
0000000000000000000
0000000000000000000
