00000000000000000000
00000000000000000000
00011111111111111000
00000000000000000000
00000000000000000000
00000000000000000000
00000000000000000000
00000000000000000000
00000000000000000000
00000111111111100000
00000000000000000000
00000000000000000000
00000000000000000000
00000000000000000000
00000000000000000000
00000000000000000000
01111110000001111110
00000000000000000000
00000000000000000000
00000000000000000000
